Advanced AWT----['Advanced AWT', 'Input and Output', 'Advanced Swing']	['Shapes']----['Clipping', 'The Rendering Pipeline', 'Shapes']
Database Programming----['Database Programming', 'Native Methods', 'The Date and Time API']	['The Design of JDBC', 'Query Execution']----['The Design of JDBC', 'Advanced SQL Types', 'JDBC Configuration']
Advanced Swing----['Advanced Swing', 'Database Programming', 'Advanced AWT']	['Tables']----['Tables', 'Lists', 'Component Organizers and Decorators']
Advanced AWT----['Advanced AWT', 'Scripting, Compiling, and Annotation Processing', 'XML']	['Printing', 'The Rendering Pipeline']----['The Rendering Pipeline', 'Printing', 'Rendering Hints']
Advanced Swing----['Database Programming', 'Advanced AWT', 'Advanced Swing']	['Component Organizers and Decorators']----['Component Organizers and Decorators', 'Tables', 'Text Components']
Input and Output----['Input and Output', 'XML', 'Advanced AWT']	['Regular Expressions']----['Regular Expressions', 'Text Input and Output', 'Reading and Writing Binary Data']
XML----['XML', 'Input and Output', 'Native Methods']	['Parsing an XML Document']----['Streaming Parsers', 'XSL Transformations', 'Generating XML Documents']
Advanced AWT----['Database Programming', 'Native Methods', 'Input and Output']	['Platform Integration']----['Drag and Drop', 'The Clipboard', 'Transparency and Composition']
Scripting, Compiling, and Annotation Processing----['Scripting, Compiling, and Annotation Processing', 'XML', 'Advanced AWT']	['Scripting for the Java Platform']----['Scripting for the Java Platform', 'The Compiler API', 'Standard Annotations']
Database Programming----['Database Programming', 'Networking', 'Security']	['JDBC Configuration', 'Working with JDBC Statements']----['JDBC Configuration', 'Working with JDBC Statements', 'The Design of JDBC']
Advanced AWT----['Advanced AWT', 'Input and Output', 'Advanced Swing']	['Shapes']----['Coordinate Transformations', 'Paint', 'Image Manipulation']
Advanced Swing----['Advanced Swing', 'Database Programming', 'Scripting, Compiling, and Annotation Processing']	['Tables', 'Progress Indicators']----['Tables', 'Lists', 'Text Components']
Database Programming----['Database Programming', 'The Java SE 8 Stream Library', 'Native Methods']	['Query Execution']----['Advanced SQL Types', 'JDBC Configuration', 'Working with JDBC Statements']
Database Programming----['Database Programming', 'Native Methods', 'Input and Output']	['Working with JDBC Statements']----['Working with JDBC Statements', 'Scrollable and Updatable Result Sets', 'Query Execution']
XML----['XML', 'Scripting, Compiling, and Annotation Processing', 'Internationalization']	['Streaming Parsers', 'Parsing an XML Document']----['Using Namespaces', 'Parsing an XML Document', 'Introducing XML']
Advanced Swing----['Advanced AWT', 'Advanced Swing', 'Internationalization']	['Text Components']----['Text Components', 'Component Organizers and Decorators', 'Lists']
XML----['Scripting, Compiling, and Annotation Processing', 'Database Programming', 'Advanced Swing']	['Parsing an XML Document']----['XSL Transformations', 'Generating XML Documents', 'Locating Information with XPath']
Input and Output----['XML', 'Input and Output', 'Internationalization']	['Working with Files', 'Text Input and Output']----['Reading and Writing Binary Data', 'Text Input and Output', 'Input/Output Streams']
Database Programming----['Database Programming', 'Native Methods', 'Input and Output']	['JDBC Configuration', 'Working with JDBC Statements']----['JDBC Configuration', 'Transactions', 'Advanced SQL Types']
Database Programming----['Database Programming', 'Input and Output', 'Scripting, Compiling, and Annotation Processing']	['Scrollable and Updatable Result Sets', 'Working with JDBC Statements']----['Transactions', 'Scrollable and Updatable Result Sets', 'Working with JDBC Statements']
Database Programming----['Database Programming', 'Networking', 'Security']	['JDBC Configuration', 'Working with JDBC Statements']----['JDBC Configuration', 'The Design of JDBC', 'Row Sets']
Advanced Swing----['Internationalization', 'Networking', 'Advanced Swing']	['Text Components']----['Text Components', 'Component Organizers and Decorators', 'Progress Indicators']
Input and Output----['Input and Output', 'The Java SE 8 Stream Library', 'Internationalization']	['Regular Expressions']----['Regular Expressions', 'Reading and Writing Binary Data', 'Text Input and Output']
Database Programming----['Database Programming', 'The Java SE 8 Stream Library', 'Input and Output']	['Query Execution', 'Working with JDBC Statements']----['Scrollable and Updatable Result Sets', 'Working with JDBC Statements', 'Advanced SQL Types']
Database Programming----['Database Programming', 'Scripting, Compiling, and Annotation Processing', 'Native Methods']	['Working with JDBC Statements']----['Advanced SQL Types', 'JDBC Configuration', 'The Design of JDBC']
Networking----['XML', 'Security', 'Native Methods']	['Getting Web Data']----['Getting Web Data', 'Sending E-Mail', 'Implementing Servers']
Input and Output----['Input and Output', 'The Java SE 8 Stream Library', 'Internationalization']	['Text Input and Output', 'Input/Output Streams']----['Input/Output Streams', 'Text Input and Output', 'Reading and Writing Binary Data']
Advanced Swing----['Advanced Swing', 'Advanced AWT', 'Database Programming']	['Component Organizers and Decorators']----['Component Organizers and Decorators', 'Tables', 'Trees']
Input and Output----['Input and Output', 'Native Methods', 'Security']	['Working with Files']----['Input/Output Streams', 'Reading and Writing Binary Data', 'Memory-Mapped Files']
Advanced Swing----['XML', 'Advanced Swing', 'Scripting, Compiling, and Annotation Processing']	['Trees']----['Trees', 'Tables', 'Lists']
Advanced Swing----['XML', 'Database Programming', 'Advanced Swing']	['Lists']----['Lists', 'Trees', 'Tables']
XML----['XML', 'Advanced AWT', 'Scripting, Compiling, and Annotation Processing']	['XSL Transformations']----['Introducing XML', 'XSL Transformations', 'Using Namespaces']
Advanced Swing----['Native Methods', 'Input and Output', 'Scripting, Compiling, and Annotation Processing']	['Tables']----['Tables', 'Lists', 'Trees']
Database Programming----['Database Programming', 'The Date and Time API', 'Networking']	['Working with JDBC Statements']----['Transactions', 'Scrollable and Updatable Result Sets', 'Working with JDBC Statements']
Input and Output----['Input and Output', 'Native Methods', 'The Java SE 8 Stream Library']	['Object Input/Output Streams and Serialization', 'Working with Files']----['Input/Output Streams', 'Reading and Writing Binary Data', 'Text Input and Output']
Advanced Swing----['Advanced AWT', 'Advanced Swing', 'XML']	['Text Components']----['Text Components', 'Component Organizers and Decorators', 'Tables']
Input and Output----['Advanced AWT', 'Input and Output', 'Internationalization']	['Regular Expressions']----['Regular Expressions', 'Text Input and Output', 'Input/Output Streams']
Input and Output----['XML', 'Native Methods', 'Database Programming']	['Working with Files']----['Input/Output Streams', 'Reading and Writing Binary Data', 'Working with Files']
Input and Output----['XML', 'Scripting, Compiling, and Annotation Processing', 'Advanced Swing']	['Working with Files']----['Text Input and Output', 'Regular Expressions', 'Working with Files']
Advanced Swing----['Advanced Swing', 'Database Programming', 'XML']	['Tables']----['Tables', 'Lists', 'Text Components']
Input and Output----['XML', 'Input and Output', 'Internationalization']	['Working with Files']----['Text Input and Output', 'Reading and Writing Binary Data', 'Input/Output Streams']
XML----['XML', 'Native Methods', 'Database Programming']	['Generating XML Documents']----['Generating XML Documents', 'Locating Information with XPath', 'Using Namespaces']
Advanced Swing----['XML', 'Advanced AWT', 'Scripting, Compiling, and Annotation Processing']	['Tables']----['Tables', 'Component Organizers and Decorators', 'Lists']
Advanced AWT----['Advanced AWT', 'Advanced Swing', 'Native Methods']	['Paint']----['Paint', 'The Rendering Pipeline', 'Coordinate Transformations']
Database Programming----['Database Programming', 'Native Methods', 'Advanced Swing']	['Scrollable and Updatable Result Sets', 'Working with JDBC Statements']----['Scrollable and Updatable Result Sets', 'Working with JDBC Statements', 'Row Sets']
Networking----['Networking', 'Security', 'XML']	['Getting Web Data']----['Connecting to a Server', 'Sending E-Mail', 'Getting Web Data']
Advanced Swing----['Advanced AWT', 'Advanced Swing', 'Input and Output']	['Component Organizers and Decorators']----['Component Organizers and Decorators', 'Lists', 'Tables']
Input and Output----['Input and Output', 'Internationalization', 'Native Methods']	['Regular Expressions']----['Regular Expressions', 'Text Input and Output', 'Reading and Writing Binary Data']
Database Programming----['Database Programming', 'Native Methods', 'Security']	['Connection Management in Web and Enterprise Applications', 'JDBC Configuration']----['Transactions', 'Advanced SQL Types', 'JDBC Configuration']
Advanced Swing----['The Date and Time API', 'Internationalization', 'Input and Output']	['Text Components']----['Component Organizers and Decorators', 'Text Components', 'Tables']
Advanced Swing----['Database Programming', 'Security', 'XML']	['Trees']----['Trees', 'Lists', 'Tables']
Database Programming----['Database Programming', 'Security', 'Scripting, Compiling, and Annotation Processing']	['JDBC Configuration', 'Working with JDBC Statements']----['Transactions', 'JDBC Configuration', 'Scrollable and Updatable Result Sets']
XML----['XML', 'Input and Output', 'Internationalization']	['Parsing an XML Document', 'Streaming Parsers']----['Introducing XML', 'Using Namespaces', 'Generating XML Documents']
XML----['XML', 'Database Programming', 'Scripting, Compiling, and Annotation Processing']	['Parsing an XML Document', 'Streaming Parsers']----['Using Namespaces', 'Introducing XML', 'Validating XML Documents']
Database Programming----['Database Programming', 'Input and Output', 'Native Methods']	['Query Execution', 'Working with JDBC Statements']----['Scrollable and Updatable Result Sets', 'Advanced SQL Types', 'Working with JDBC Statements']
Database Programming----['Database Programming', 'The Date and Time API', 'XML']	['Row Sets']----['Transactions', 'Scrollable and Updatable Result Sets', 'Advanced SQL Types']
Advanced Swing----['Advanced AWT', 'Advanced Swing', 'Input and Output']	['Component Organizers and Decorators']----['Component Organizers and Decorators', 'Trees', 'Tables']
XML----['XML', 'Input and Output', 'Scripting, Compiling, and Annotation Processing']	['Parsing an XML Document', 'Streaming Parsers']----['Using Namespaces', 'Validating XML Documents', 'Introducing XML']
Database Programming----['Database Programming', 'Security', 'Native Methods']	['Working with JDBC Statements']----['Working with JDBC Statements', 'JDBC Configuration', 'The Structured Query Language']
Input and Output----['Input and Output', 'The Java SE 8 Stream Library', 'Internationalization']	['Regular Expressions']----['Regular Expressions', 'Reading and Writing Binary Data', 'Text Input and Output']
Database Programming----['Database Programming', 'Security', 'Networking']	['Row Sets']----['JDBC Configuration', 'The Design of JDBC', 'Advanced SQL Types']
Database Programming----['Native Methods', 'Security', 'Input and Output']	['Working with JDBC Statements']----['Working with JDBC Statements', 'Advanced SQL Types', 'Scrollable and Updatable Result Sets']
Input and Output----['Input and Output', 'XML', 'The Java SE 8 Stream Library']	['Working with Files']----['Input/Output Streams', 'Reading and Writing Binary Data', 'Text Input and Output']
Advanced Swing----['Advanced AWT', 'Native Methods', 'Input and Output']	['Tables']----['Tables', 'Component Organizers and Decorators', 'Lists']
Advanced AWT----['Advanced AWT', 'Advanced Swing', 'The Java SE 8 Stream Library']	['The Clipboard']----['The Clipboard', 'Clipping', 'Drag and Drop']
Database Programming----['Database Programming', 'XML', 'Scripting, Compiling, and Annotation Processing']	['Working with JDBC Statements', 'Row Sets']----['Advanced SQL Types', 'Row Sets', 'JDBC Configuration']
Input and Output----['Input and Output', 'Scripting, Compiling, and Annotation Processing', 'Advanced Swing']	['Object Input/Output Streams and Serialization']----['Object Input/Output Streams and Serialization', 'Reading and Writing Binary Data', 'Text Input and Output']
Input and Output----['Input and Output', 'Security', 'Native Methods']	['Working with Files']----['Working with Files', 'Input/Output Streams', 'Reading and Writing Binary Data']
Input and Output----['Internationalization', 'Input and Output', 'Advanced Swing']	['Object Input/Output Streams and Serialization']----['Object Input/Output Streams and Serialization', 'Regular Expressions', 'Memory-Mapped Files']
Database Programming----['Database Programming', 'Security', 'Native Methods']	['JDBC Configuration']----['The Design of JDBC', 'JDBC Configuration', 'Transactions']
Database Programming----['Database Programming', 'Networking', 'Scripting, Compiling, and Annotation Processing']	['JDBC Configuration']----['JDBC Configuration', 'Transactions', 'The Design of JDBC']
Advanced Swing----['Database Programming', 'Internationalization', 'Security']	['Text Components']----['Text Components', 'Trees', 'Tables']
Advanced AWT----['Advanced AWT', 'Advanced Swing', 'Internationalization']	['The Rendering Pipeline']----['Clipping', 'Rendering Hints', 'The Rendering Pipeline']
Advanced Swing----['Internationalization', 'Advanced AWT', 'Advanced Swing']	['Component Organizers and Decorators']----['Text Components', 'Component Organizers and Decorators', 'Lists']
Advanced Swing----['Database Programming', 'XML', 'Advanced Swing']	['Trees']----['Trees', 'Tables', 'Text Components']
XML----['XML', 'Scripting, Compiling, and Annotation Processing', 'Security']	['Introducing XML']----['Introducing XML', 'Generating XML Documents', 'XSL Transformations']
XML----['XML', 'Native Methods', 'Input and Output']	['Parsing an XML Document', 'Streaming Parsers']----['Introducing XML', 'Validating XML Documents', 'Streaming Parsers']
Database Programming----['Database Programming', 'Security', 'Native Methods']	['Working with JDBC Statements']----['Advanced SQL Types', 'Scrollable and Updatable Result Sets', 'Working with JDBC Statements']
Advanced Swing----['Advanced AWT', 'Advanced Swing', 'Native Methods']	['Text Components']----['Text Components', 'Component Organizers and Decorators', 'Progress Indicators']
Advanced Swing----['Internationalization', 'Advanced Swing', 'Native Methods']	['Text Components']----['Text Components', 'Lists', 'Tables']
XML----['XML', 'Input and Output', 'Security']	['Parsing an XML Document', 'Streaming Parsers']----['Streaming Parsers', 'XSL Transformations', 'Generating XML Documents']
Database Programming----['Database Programming', 'Networking', 'Security']	['Working with JDBC Statements', 'JDBC Configuration']----['JDBC Configuration', 'Working with JDBC Statements', 'Metadata']
Advanced Swing----['Advanced Swing', 'Advanced AWT', 'XML']	['Tables']----['Tables', 'Trees', 'Text Components']
Database Programming----['Database Programming', 'Native Methods', 'XML']	['Working with JDBC Statements']----['Working with JDBC Statements', 'Advanced SQL Types', 'JDBC Configuration']
Advanced AWT----['Advanced AWT', 'Advanced Swing', 'XML']	['Paint', 'Image Manipulation']----['Paint', 'Clipping', 'The Rendering Pipeline']
Input and Output----['Security', 'Database Programming', 'Networking']	['Object Input/Output Streams and Serialization']----['Object Input/Output Streams and Serialization', 'Working with Files', 'Reading and Writing Binary Data']
Advanced AWT----['Advanced AWT', 'Scripting, Compiling, and Annotation Processing', 'Advanced Swing']	['Paint']----['Paint', 'Drag and Drop', 'Image Manipulation']
Database Programming----['Database Programming', 'Native Methods', 'Input and Output']	['Working with JDBC Statements']----['Transactions', 'Scrollable and Updatable Result Sets', 'Advanced SQL Types']
Advanced Swing----['Advanced AWT', 'Advanced Swing', 'Input and Output']	['Component Organizers and Decorators']----['Component Organizers and Decorators', 'Lists', 'Text Components']
XML----['XML', 'Native Methods', 'Input and Output']	['Parsing an XML Document', 'Streaming Parsers']----['Parsing an XML Document', 'Validating XML Documents', 'Streaming Parsers']
XML----['XML', 'Security', 'Scripting, Compiling, and Annotation Processing']	['Using Namespaces']----['Using Namespaces', 'Generating XML Documents', 'Parsing an XML Document']
Networking----['Networking', 'Security', 'Database Programming']	['Implementing Servers', 'Interruptible Sockets']----['Sending E-Mail', 'Connecting to a Server', 'Getting Web Data']
Database Programming----['Database Programming', 'Security', 'Native Methods']	['Working with JDBC Statements', 'Query Execution']----['Working with JDBC Statements', 'Scrollable and Updatable Result Sets', 'Advanced SQL Types']
Input and Output----['Input and Output', 'Internationalization', 'XML']	['Regular Expressions']----['Regular Expressions', 'Reading and Writing Binary Data', 'Text Input and Output']
Input and Output----['XML', 'Input and Output', 'The Java SE 8 Stream Library']	['Regular Expressions']----['Reading and Writing Binary Data', 'Text Input and Output', 'Input/Output Streams']
Database Programming----['Database Programming', 'The Java SE 8 Stream Library', 'Input and Output']	['JDBC Configuration']----['Transactions', 'Scrollable and Updatable Result Sets', 'JDBC Configuration']
Input and Output----['XML', 'Advanced AWT', 'Internationalization']	['Regular Expressions']----['Regular Expressions', 'Working with Files', 'Text Input and Output']
Networking----['Networking', 'Database Programming', 'Security']	['Implementing Servers', 'Connecting to a Server']----['Sending E-Mail', 'Connecting to a Server', 'Implementing Servers']
Database Programming----['Database Programming', 'Native Methods', 'Input and Output']	['Working with JDBC Statements', 'Query Execution']----['Transactions', 'Scrollable and Updatable Result Sets', 'JDBC Configuration']
Input and Output----['Input and Output', 'Database Programming', 'Security']	['Regular Expressions']----['Object Input/Output Streams and Serialization', 'Input/Output Streams', 'Reading and Writing Binary Data']
